#####
# P #
#####
#  E#
#####
