######
# P  #
#  E #
######
#    #
#  C #
######
