###################
#        #        #
#     E  #        #
#   ######        #
##  #       P     #
#   #    #####    #
#   #    #        #
#  ##    #    ### #
#                 #
#                 #
###################
