###################
#C       #        #
#     E  #    C   #
#   ######        #
##  #       P     #
#   #    #####    #
#   #    #        #
#  ## C  #    ### #
#                 #
#                 #
###################
