#######
#  C  #
#  P  #
#     #
#  E  #
#     #
#######
