11111
10001
10P01
10001
10E01
11111
