#########
#  P    #
#       #
#       #
#       #
#    E  #
#########
