#######
#     #
#  P  #
#     #
#  E  #
#     #
#######
