###################
#        #        #
#   # P  #    #   #
#   ######    #   #
#   #         #   #
#   #    ######   #
#   #    #        #
#   #    #        #
#        #     E  #
#        #        #
###################
